134
8
22 4 0 0 0 0 0 0 0 0 0 0 0 0 0 0 0 0 0 0 0 0 0 0 0 0 0 0 0 0 0 0 0 0 0 0 0 0 0 0 0 0 0 0 0 0 0 0 0 0 0 0 0 0 0 0 0 0 0 0 0 0 0 0 0 0 0 0 0 0 0 0 0 0 0 0 0 0 0 0 0 0 0 0 0 0 0 3 22 22 22 22 22 22 22 22 4 0 0 0 0 0 0 0 0 0 0 0 0 0 0 0 0 0 0 0 0 0 0 0 0 0 0 0 0 0 0 0 0 0 0 0 0 0 
22 4 0 0 0 0 0 0 0 0 0 0 0 0 0 0 0 0 0 0 0 0 0 0 0 0 0 11 0 0 0 0 0 0 0 0 0 0 0 0 0 0 0 0 0 0 0 0 0 0 0 0 0 0 0 0 0 0 0 0 0 0 0 0 0 0 0 0 0 0 0 0 0 0 0 0 0 0 0 0 0 0 0 0 11 0 0 0 17 18 22 22 22 22 19 17 0 0 0 0 0 0 0 0 0 0 0 0 0 0 0 0 0 0 0 0 0 0 0 0 0 0 0 0 0 0 0 0 0 0 0 0 0 0 
22 4 0 0 0 0 0 0 0 0 0 0 0 0 0 0 0 0 0 14 0 0 0 0 0 0 23 25 0 0 0 0 0 0 0 0 0 0 10 0 0 0 0 0 0 0 0 0 0 0 0 0 0 0 0 0 0 0 0 0 0 0 9 0 0 0 0 0 0 0 0 0 0 0 0 0 0 0 0 0 0 0 23 24 25 0 0 0 10 0 18 22 22 19 0 9 0 0 0 0 0 0 0 0 0 0 0 0 0 0 0 0 0 0 0 0 0 0 0 0 0 0 0 0 0 0 0 0 0 0 0 0 0 0 
22 4 0 0 0 0 13 0 0 0 0 0 0 0 0 0 11 0 0 0 0 0 10 0 0 0 0 0 0 0 0 0 0 0 0 0 0 0 23 25 0 0 0 0 0 0 0 0 0 0 0 0 0 0 0 10 0 0 0 0 0 23 24 25 0 0 0 0 0 11 0 0 0 0 0 0 0 0 9 0 0 0 0 0 0 0 0 1 21 2 0 17 17 0 1 21 2 0 0 0 0 0 0 0 0 0 0 0 0 0 0 0 0 0 0 0 0 0 0 0 0 0 0 0 0 0 0 0 0 0 0 0 0 0 
22 4 0 0 0 0 0 0 0 10 0 0 0 0 0 1 21 2 0 0 0 1 21 2 0 0 0 0 0 16 0 0 0 9 0 0 0 0 0 0 0 0 0 0 0 1 21 2 0 9 0 0 11 0 1 21 2 0 0 0 0 0 0 0 0 0 0 0 1 21 2 0 10 0 0 11 0 1 21 2 0 0 0 0 0 0 0 3 5 21 2 0 0 1 21 6 4 0 0 0 0 0 0 0 10 11 0 0 0 0 0 0 0 0 0 0 0 0 0 0 11 0 0 0 0 0 0 10 0 0 0 0 0 0 
22 4 0 11 0 0 0 0 1 21 2 0 0 0 1 21 7 21 2 9 11 3 22 4 0 0 0 0 0 0 0 0 0 23 25 0 0 0 0 0 0 0 0 0 0 3 5 21 21 21 21 21 21 21 21 6 4 0 0 0 0 0 0 0 0 0 0 0 3 5 21 21 21 21 21 21 21 21 6 4 0 0 0 9 0 0 0 3 22 5 21 2 1 21 6 22 4 0 0 0 0 0 0 23 24 25 0 0 0 0 0 0 1 21 2 9 10 0 0 1 21 2 0 0 9 0 1 21 2 0 0 0 11 9 
22 4 23 24 25 0 0 0 3 5 21 2 9 0 3 22 22 5 21 21 21 21 22 4 0 0 0 0 0 0 0 0 0 0 0 0 0 0 0 0 0 0 0 0 0 3 22 22 22 19 9 10 18 22 22 22 4 0 0 0 0 0 0 0 0 0 0 0 3 22 22 22 19 9 10 18 22 22 22 4 0 0 23 24 25 0 0 3 22 22 5 21 21 6 22 22 4 0 0 0 0 0 0 0 0 0 0 0 0 0 0 0 3 5 21 21 21 21 21 21 7 21 21 21 21 21 21 7 21 21 21 21 21 21 
22 4 0 0 0 0 0 0 3 22 5 21 21 21 21 6 22 22 22 22 22 22 22 4 0 0 0 0 0 0 0 0 0 0 0 0 0 0 0 0 0 0 0 0 0 3 22 22 5 21 21 21 21 6 22 22 4 0 0 0 0 0 0 0 0 0 0 0 3 22 22 5 21 21 21 21 6 22 22 4 0 0 0 0 0 0 0 3 22 22 22 22 22 22 22 22 4 0 0 0 0 0 0 0 0 0 0 0 0 0 0 0 3 22 22 22 22 22 22 22 22 22 22 22 22 22 22 22 22 22 22 22 22 22 
