134
8
22 4 0 0 0 0 0 0 0 0 0 0 0 0 0 0 0 0 0 0 0 0 0 0 0 0 0 0 0 0 0 0 0 0 0 0 0 0 0 0 0 0 0 0 3 22 22 22 22 22 22 22 22 22 22 22 22 22 22 22 22 22 22 22 22 22 22 22 22 22 22 22 22 22 22 22 4 0 0 0 0 0 0 0 0 0 0 0 0 0 0 0 0 0 0 0 0 0 0 0 0 0 0 0 0 0 0 0 0 0 0 0 0 0 0 0 0 0 0 0 0 0 0 0 0 0 0 0 0 0 0 0 0 0 
22 4 0 0 0 0 0 0 0 0 0 0 0 0 0 0 0 0 0 0 0 0 0 0 0 0 0 0 0 0 0 0 0 0 0 0 0 0 0 0 0 0 0 0 3 22 22 22 22 22 22 22 22 22 22 22 22 22 22 22 22 19 17 17 17 17 17 17 17 17 17 17 17 17 17 17 0 0 0 0 0 0 0 0 0 0 0 0 0 0 0 0 0 0 0 0 0 0 0 0 0 0 0 0 0 0 0 0 0 0 0 0 0 0 0 0 0 0 0 0 0 0 0 0 0 0 0 0 0 0 0 0 0 0 
22 4 0 0 0 0 0 0 0 0 0 0 0 0 0 0 0 0 0 14 0 0 0 0 0 0 0 0 0 0 0 0 0 0 0 0 0 0 0 0 0 0 0 0 0 17 17 17 17 17 17 17 17 17 17 17 17 17 17 17 17 0 0 0 0 0 0 0 0 0 0 0 0 0 0 0 0 0 0 0 0 0 0 0 0 0 0 0 0 0 0 0 0 11 0 0 0 0 0 0 0 0 0 0 0 0 0 0 0 10 0 0 0 0 0 0 0 0 0 0 0 0 0 0 0 0 0 0 0 0 0 0 0 0 
22 4 0 0 0 0 13 0 0 0 0 0 0 0 0 0 0 0 10 0 0 0 0 0 0 0 0 10 0 0 0 0 0 0 0 0 0 0 0 0 9 0 0 0 0 0 0 0 0 0 0 0 0 0 0 0 0 0 0 0 0 0 0 10 0 11 0 0 0 0 0 0 0 0 0 0 0 0 0 0 0 0 0 0 0 0 0 0 0 0 0 0 1 21 2 0 0 0 0 0 0 0 0 0 0 0 0 0 1 21 2 0 0 0 0 0 0 0 0 11 0 0 0 0 0 0 0 9 0 0 0 0 0 0 
22 4 0 0 0 0 0 11 0 0 0 1 21 2 9 0 0 1 21 2 0 0 0 0 0 0 0 23 25 16 0 0 0 0 0 0 0 0 0 0 23 25 0 0 0 0 10 0 0 0 0 0 0 11 0 9 0 0 0 0 0 0 1 21 21 21 2 0 0 0 0 9 0 0 0 0 0 0 10 0 0 0 0 0 0 11 0 0 0 0 0 1 21 7 21 2 0 0 0 0 0 0 0 0 0 0 0 1 21 6 4 0 0 0 0 0 0 0 1 21 2 0 0 0 0 0 1 21 2 0 0 0 0 0 
22 4 0 12 0 0 23 24 25 0 0 3 5 21 21 21 21 21 6 4 0 0 0 0 0 0 0 0 0 0 0 9 0 0 0 0 0 0 0 0 0 0 0 0 1 21 21 21 21 21 2 0 1 21 21 21 21 2 0 0 0 0 3 22 22 22 4 0 0 0 23 24 25 0 0 0 0 23 24 25 0 0 0 0 23 24 25 0 0 0 1 21 6 22 5 21 2 0 9 0 0 11 0 0 0 9 1 21 6 22 4 0 0 0 0 0 10 1 21 7 21 2 0 0 10 1 21 7 21 2 0 0 0 11 
22 4 10 0 0 0 0 0 0 0 0 3 22 19 11 9 17 18 22 4 0 0 0 0 1 21 2 0 0 11 1 21 21 2 0 10 1 21 2 0 0 0 0 0 3 22 17 9 17 22 4 0 3 22 17 10 22 4 0 11 0 1 21 6 22 22 4 0 0 0 0 0 0 0 0 0 0 0 0 0 0 0 0 0 0 0 0 0 0 0 3 22 22 9 22 5 21 21 21 21 21 21 21 21 21 21 21 6 22 22 4 0 0 0 0 1 21 21 6 22 5 21 21 21 21 21 6 22 5 21 21 21 21 21 
5 21 21 21 21 2 0 0 0 0 0 3 5 21 21 21 21 21 6 4 0 0 0 0 3 5 21 21 21 21 21 6 5 21 21 21 21 6 4 0 0 0 0 0 3 5 21 21 21 6 4 0 3 5 21 21 7 21 21 21 21 21 6 22 22 22 4 0 0 0 0 0 0 0 0 0 0 0 0 0 0 0 0 0 0 0 0 0 0 0 3 22 5 21 6 22 22 22 22 22 22 22 22 22 22 22 22 22 22 22 4 0 0 0 0 3 22 22 22 22 22 22 22 22 22 22 22 22 22 22 22 22 22 22 
