82
8
22 4 0 0 0 0 0 0 0 0 0 0 0 0 0 0 0 0 0 0 0 0 0 0 0 0 0 0 0 0 0 0 0 0 0 0 0 0 0 0 0 0 0 0 3 22 22 22 22 22 22 22 22 22 22 22 22 22 22 22 22 22 22 22 22 22 22 22 22 22 22 22 22 22 22 22 4 0 0 0 0 0 
22 4 0 0 0 0 0 0 0 0 0 0 0 0 0 0 0 0 0 0 0 0 0 0 0 0 0 0 0 0 0 0 0 0 0 0 0 0 0 0 0 0 0 0 3 22 22 22 22 22 22 22 22 22 19 11 10 17 18 22 22 19 17 17 17 17 17 17 17 17 17 18 22 22 22 22 4 0 0 0 0 0 
22 4 0 0 0 0 0 0 0 0 0 0 0 0 0 0 0 0 0 14 0 0 0 0 0 0 0 0 0 0 0 0 0 0 0 0 0 0 0 0 0 11 0 0 0 17 17 17 17 18 22 22 22 5 21 21 21 21 21 6 22 4 0 0 0 0 0 0 0 0 0 0 17 18 22 22 4 0 0 0 0 0 
22 4 0 0 0 0 13 0 0 0 0 0 0 0 0 0 11 0 0 0 0 0 0 0 0 0 0 0 0 0 0 0 0 0 0 11 0 0 0 0 23 24 25 0 0 0 0 0 0 0 17 17 18 22 22 22 22 22 22 22 22 4 0 10 0 11 0 0 0 0 0 0 0 0 17 17 0 0 0 0 0 0 
22 4 0 0 0 0 0 9 0 0 0 1 21 21 21 21 21 2 0 0 0 0 0 0 0 0 0 15 0 16 0 0 0 0 23 25 0 0 0 0 0 0 0 0 0 0 10 0 0 0 0 0 0 17 17 17 17 17 17 17 17 0 1 21 21 21 2 0 0 0 0 0 0 0 0 0 0 0 0 0 0 0 
22 4 0 12 0 1 21 21 21 2 10 3 22 22 22 22 22 4 0 0 0 0 10 0 9 0 0 0 0 0 0 9 0 0 0 0 0 0 9 0 0 0 0 0 1 21 21 21 21 2 0 0 0 0 0 0 11 0 0 0 0 0 3 22 22 22 4 0 0 0 0 0 0 0 0 0 0 0 0 0 0 0 
22 4 11 0 0 3 22 22 5 21 21 21 6 19 11 18 22 4 0 0 0 1 21 21 21 21 2 0 0 11 1 21 21 2 0 10 1 21 21 2 0 0 0 0 3 22 22 22 22 4 0 9 0 0 1 21 21 2 0 9 0 1 21 6 22 22 4 0 0 0 0 0 0 0 9 0 10 0 0 0 0 11 
5 21 21 21 21 21 6 22 22 22 22 22 5 21 21 21 6 4 0 0 0 3 22 22 22 22 21 21 21 21 21 6 5 21 21 21 21 6 22 4 0 0 0 0 3 22 22 22 5 21 21 21 21 21 21 21 21 21 21 21 21 21 6 22 22 22 4 0 0 0 0 0 1 21 21 21 21 21 21 21 21 21 
